################################################################
#P..#..............#...........................................#
#..................#...........................................#
#####..............#...........................................#
#.................#............................................#
#..............................................................#
#..............................................................#
#.............#................................................#
#..............................................................#
#..............................................................#
#...............................#..............................#
#..............................................................#
#...............#..............................................#
#..............................................................#
#..............................................................#
#..............................................................#
#..............................................................#
#..............................................................#
#..............................................................#
#..............................................................#
################################################################